C   E   D I   H   I   J G   H   G   G J             
E   E   G     I   H B C H   G   E   J G             
D   J   B J   E   G   H E   D   D   D G             
J   E   H   I D   G   J   E J   E       I           
G   E   I   I E   H   J   G J       H   J           
D   G   H   J     E   G   H B   I       E           
B   J   H   D G   H   J   H I   E   G   D           
  J J   H   I   J     J   E   I G   G   B           
    E   H   H   D I       G   G G   J   B           
  G   B E   I   D   G J   G   G C   E   B           
  E   B G   I   E   C C   E   E   B G   B           
  J     B   C   G   G     B   C   G G               
                                                    
                                                    
                                                    
                                                    
                                                    
